%%%%%%%%%%%%%%%%%%%%%%%%%%%%%%%%%%%%%%%%%%
%.% %  %       %   %P % %      %        .%
% % % %%%%% %%        %    %     %  % %  %
% % %  %           %  %%%%%%% %%%%%%%%%% %
%   %  %%%%%%%% %%    %             %    %
% % %% %        %       %%%%%% %%%% %%% %%
% %       %% %% %% %  %  % %   %  %      %
%%% % %%   %  %    %  %  % % % % %%% %%%%%
% % %  %%%%% %% %     % %% %   %  %  % % %
% % %  %  %   % %% %       %%     %% %   %
% % % %%  %   % %  %  %%%% %   % %%  % % %
% % %  %% %   % %%%%  %  % %   %  %% % % %
%   % %%     %%       % %% %   %  %  % % %
% % %  %  %   % %% %     % %% %%%%%  % % %
%%%%% %%% % % % %  %  %    %  %   %% % %%%
%      %  %   % %  %  % %% %% %%       % %
%% %%% %%%% %%%%%%       %        % %% % %
%    %             %    %% %%%%%%%%  %   %
% %%%%%%%%%% %%%%%%%  %           %  % % %
%  % %  %     %    %        %% %%%%% % % %
%.        %      % %  %   %       %  % %.%
%%%%%%%%%%%%%%%%%%%%%%%%%%%%%%%%%%%%%%%%%%
